lanhine.com	ｌａｎｈｉｎｅ,加厚,有限,口罩,用品
#600shop.net	ｘｎｅｕ
electronique.com	ｅｌｅｃｔｒｏｎｉｑｕｅ
gedelaojiu.com	老酒,歌德,茅台,贵宾,公司
ddblct.com	巴黎,春天,丹东,婚纱,摄影
cycjxx.com	１３９,ｊｉａｏｙｕ,ｌｎｊｚ,财经,学校
##0167.loan	成人,影视,电影,资源,色情
europeglobalinx.com	速递
leespharm.com	罗芬,李氏,药厂,控股,凝胶
ddaim.com	航空,丹东,机械
#0591sx.com	自动,最新
apexbicycles.com	派克,ｍａ,８３００,自行车,ｔ６０
##36x1.com	好彩
#axmama.cn	７３８３９３,回旋,教学,图片,麻将
lszt.cn	中心,王斐,老师,照片,中学
##ttzhqcyp.com	汽车,用品
58king.com	电子,方卓,夏门,厦门,负离子
fuguixie.com	史瑞夫,旗舰店,ｓｈｉｒｕｉｆｕ,品牌
#hbsimote.com	新闻,洪湖,房地产,信息,洪湖市
hvs.com	ｈｏｔｅｌ,ａｎｄ,ｔｈｅ,ｍａｎａｇｅｍｅｎｔ,ｈｖｓ
##fslitongle.com	童车,佛山,童乐,用品,儿童
#baxterslinks.com	ｒｅａｌｉｔｙｋｉｎｇｓ,５６,ｒｅａｌｉｔｙｋｉｎｇｓｃｏｍ
#shuishanglao.com	水上,用法
##zlxy87.com	孕妇,护肤品,排行,适合,品牌
wanfeng0769.com	食品,东莞,万丰,大碗,１３６０２３８１４６２
maotime.com	猫粮,推荐
sta11.com	平台,订货
xqjapi.com	３０８,白癜风,长沙,效果,医院
##161676.com	图片,专区,情色,色图,在线
hechangba.com	合唱,中国,指挥,拍子,简谱
bxxlght.com	ｂｘｘｌｇｈｔ,ｌｅｄ,有机,玻璃,灯箱
baijiaenzymes.com	生物,辽宁,科技,公司,有限
#jxayyz.com	党员,权利,义务,安远,制度
hlcorp.com	实业,ｚｏｏｍ,ｈｌｃｏｒｐ
#0768zc.com	０７６８,ｚｃ
junnian8458.com	易购
#hendrysos.com	１１,十一,开奖,１９４７,玩法
dayunhome.com	中海,康城,深圳,国际,车震
##qiaonaishop.cn	价格,皮鞋
sclnedu.com	雷诺,四川
nbpegasus.net	帕克斯,机械,招聘,公司,有限
whzxz.com	批发,香猪,威海
tmeizs.com	代孕,合肥,公司
fanmeng.webcam	ｂａｉｄｕ,ｆｒｏｍ,ｎａｖ,ｗｉｓｅ,ｖｉｄｅｏ
sggfjy.com	征兵,大学,广东省,韶关,韶关市
jmtshg.com	荆门,化工
##zzyskj.cn	蜗牛
52lvyou.com	驴友
zzpuppet.com	艺术,木偶,学校,漳州
hunche114.com	临沂,婚礼,车队,山东,苍山
#reviewowl.com	ｙａｍａｈａ,４９２,ａｖ,１４０,５５７１
##zhicunxiou.com	完整,新金,龚玥菲,高清,３ｄ
baoyuanpu.com	线条,ｐｕ,厂家,价格,装饰
qingdaozhongwei.com	科技,有限,公司,青岛
#faqromania.com	ｒｅｖｉｅｗ,ｏｆ
haozhongjie888.com	厂家,植绒,棉布
#bbxianlx.cn	失业,顺德
bolimianchangj.com	钢管,镀锌,霸州市,厂家,有限
hderito.com	ｈｄｅｒｉｔｏ,ｊａｐａｎｅｓｅ,ｐｉｃｓ,ｐｒｏｎ
120hci.com	失眠,哈尔滨
#wfpz.top	ｚｚｚ,３４,哥哥
idcxen.com	瓦工,ｖｐｓ,登录
##woti.loan	狠狠,１８,婷婷,成人,ｘｘｂｂ
##kittyjan.com	ｋｉｔｔｙｊａｎ
rarestwater.com	温州,私家,侦探
wxhtxx.com	航天,无锡,信息,公司,有限
rzcut.com	脚垫,切割机,汽车,自动,振动
hengxiangyuan.com	添加剂,食品,青岛
aiupay.com	充值,艾优
#hy466.com	重庆,时时,技巧,稳赚,北京
#878zz.cc	ｚｚ,８７８,５６８,ｚｚｃｏｍ,ｓｅ
#xxxxmagazine.tv	ｘｘｘｘ,ｘｘｘｘｔｖ,ｗｗｗｓｈｅｎａｍ,１２０１０１１９８１０２２２,ｔｖ
vzcfk.loan	在线,日夜,视频
##cnpunk.com	修改
#49ccscooter.org	ｃｃ,４９
##dtgjpm.com	开奖,香港,资料,论坛,现场
entertainmenting.com	ｊｊ,金币,官网
##888bgb.cc	８８８,ｇｂｇｂ,ｑｘｑｘ,在线,ｂｔｂｔ
rpyg.com	太阳能,平板,瑞普,壁挂,厂家
cnlifekc.cn	公积金,人寿,住房,中国
bjjinxinzp.com	北京,帐篷,翱翔,法人,方式
##0731anmospa.com	０７３１,ａｎｍｏｓｐａ
##3791296941721667.link	天天,丁香,２６,蝴蝶,激情
#176pa.com	完美,必杀,７６
##wg99.cc	万国,赌场
##legal110.com	１１０,中心,咨询,在线,服务
howtotrainyourdragonbooks.com	ｄｒａｇｏｎ,ｔｏ,ｔｒａｉｎ,ｈｏｗ,ｙｏｕｒ
#shiqutu.com	泰州市,城区,规划,海陵
#84bbbb.com	８４,ｂｂｂｂ
fang63.com	乐山,房产,嘉州,最新,２０１６
dngstbb.com	电脑,ｗｉｎ,０ｘｃ,００００４２８,系统
zcwscl.net	设备,屠宰场
#sdjinghongbanye.com	新型,山东
meowgames.cn	ｍｚｇ,ｃｎ,ｍｅｏｗｇａｍｅｓ
qianyilong.com	揽胜
videochaterotico.org	ｅｒｏｔｉｃｏ,ｖｉｄｅｏ
360waiqin.com	３６０,外勤,ｗａｉｑｉｎ,软件
goutt.com	云南,农产品,市场,交易
jianyikongjian.com	策划书,网站,排版
##internetdating.cc	ｉｎｔｅｒｎｅｔ,ｄａｔｉｎｇ
##pmj1288.com	喷码机,小型
ayhsdg.com	安阳,汽车,专业
#hsjstn.net	义母
qdbenpaoba.com	青岛,奔跑,公司,传媒
#xiudu435.com	４３５,ｘｉｕｄｕ
##maiqijixie.com	自动,花炮,烟花,迈奇,圆形
chaozhouxw.cn	新闻,头条,潮州,国内,国际
xafeidi.com	设备,有限,机电,公司,迪斯
yubangbang.com	养殖,技术,渔业,水产,闽侯县
#jifute.com	西安,福特
tsyhyy.com	医药,永和,唐山,连锁,丰南
010chao.com	北京,生活
maucus.cn	小说,视频,无码,成人,欧美
#malopolska.pl	ｒａｃｙａｎｇｅｌ
#e01e.com	控制,用户,账户,关闭,情况
lzdezx.com	良渚,余杭区,运动会,学生,４５
#maukilo.com	ｔｏｕｃｈｉｎｇ,ｆｅｅｌｉｎｇ,游戏
liangji.hk	电讯,香港,查询,数码,发票
##6060dy.com	漫画,邪恶,少女,天使,雨夜
sscmgs.com	公司,婚庆,周口,周口市,河南
xlsm66.com	莲娜,官网,蝶恋,代理,女神
gzliqin.com	汽车,用品
#deliladder.com	配件,伸缩,得力
##cp361.cn	彩票,星空,娱乐,恒信,网站
#hostadm.net	越秀区,伟哥,菩提,中医院,星月
hongrufs.com	出租,演唱,上海,服装
##9188bifen.com	１８８,ｂｉｆｅｎ
yxbjc.com	皮肤病,过敏性,女人,怀孕,患有
skmpwgh.com	猪哥,劲爆,风云
czlengcang.com	设备,玉燕,冷藏,常州
##hgmy888.com	牛犊,价格
tuvi24h.com	ｖｉ
foxcang.com	富士康,招聘,信息,官网,地址
inori.com	ｉｎｏｒｉ
btsddz.com	汽车,包头,导航
gxguiquan.com	山茶花,格兰
cessna.cn	赛斯,飞机
acrfg.link	在线,网站,视频,播放,免费
##chinatianyuan.com	天园,制衣,海阳
tv263.tv	ｔｖ,２６３
chxldq.com	重庆,公司,电气,有限,电器
##yijiaen.com	新飞,家电
85276.win	影音
##dlbdjiajiao.com	半岛,大连,家教,教育
dyywj.date	暗暗,成人,波多,ａｎａｎｌｕ,夜夜
zzxianfeng.com	电气,郑州,先锋
susudh.cn	１５ｐ,姨妈,美女,自拍,小泽
sdhaichuan.cn	科技,沾化,生物,有限,公司
#ezcorp.com	ｌｏａｎ,ｎｘｘｅｚ
jiulongtang.cn	中医,保健,推拿,养生,调理
cqanb.com	重庆,发动机,汽车,厂家
cineeexpo.com	童装,展销会,母婴
##copsandrobbersrun.com	ｒｕｎｎｅｒｓ,ａｎｄ,ｃｏｐｓ
##jinchuanbags.com	河南,科技,学院,系统,管理
zy1234.com	沈阳,大学,员工,师范,创业
51lexing.com	武汉,代办,签证,天下
#ry1992.com	１９９２,ｒｙ
51pfp.com	煎饼机,电热,产量,加热
#shliti.com	ｌｅ,断路器,ｄｚ４７
#dhvrb.com	图片,大象,金鱼,狮子,鹦鹉
##hxxfz.com	血防,和县
jsbssy.com	金色,婚纱,苏州,摄影,婚纱照
sanzhixiaozhu.com	小猪,装修,家装,陶朱位
##dpva.loan	日本,夜夜
5x666.com	青春,视频,论坛,在线,免费
##eurolaon.com	成人,棋牌,博彩,星河,娱乐
chenlongqipaiyouxi.net	游戏,官网,棋牌
#ideclareworldpeace.org	４０４,ｆｏｕｎｄ,ｅｒｒｏｒ,频道,ｎｏｔ
lichen114.cn	手机,儿童,官网,学生
##yongxingguanye.cn	管材,漏水,大型,缝隙,武汉
xnglkj.cn	咸宁,科技,广联
shanxidermyy.com	医院,人民,山西省,山西
dqxyt.com	玻璃瓶,大庆,玻璃,运通,工厂
#ashangtao.com	捆绑,布条
jabeta.com	ｗｗｗｊａ
913jgsc.com	商城,官网
5635777.com	沧州,医院,男科
#henhenganai.cc	嫂嫂,百万,木木,潮流,嫂子
tongtongjiazheng.com	公司,上海,高端,月嫂,涉外
binggunhui.com	冰棍
##ooxc.com	ｏｏｘｃ
##9to5employment.com	ｗｗｗｘｖｉｄｅｏ,ｇｉｒｌｘｖｉｄｅｏ,ｘｘｘｖｉｄｅｏｈｄ,ｓｃｈｏｏｌｓｅｘｖｉｄｅｏ,ｘｖｉｄｅｏ
jinxiangit.com	科技,信阳,有限,公司
jstzsb.com	江苏,设备,特种,检验,研究院
bjrdsw.com	生物,瑞达,科技,公司,北京
siff.com	电影节,上海,国际,２０１５,１８
#migujiaonang.org	麦从军,太子妃,微博,好用,欧阳修
##2t6cx.loan	百度,色情,淫色,狠狠
gmcfy.cn	ａｖ,天堂,妹妹,情色,欧美
##zbgkr.cn	捕鱼,海洋,达人,手机,游戏
##changhongzx.com	公司,西安,纸制品,包装,有限
baizanjx.com	机械,精密,机器,注塑机,原理
dancingbear1.com	ｄａｎｃｉｎｇｂｅａｒ,ｂｅａｒ,ｓｅｘ,ｄａｎｃｉｎｇ,ｔｙｐｅ
#yadfz.cn	书记,上海,市委,韩政,图片
##hntxwl.com	经销商,系统,ｈｎｔｘｗｌ,武陵,天下
fszw88.com	家具,浪漫,定金,板式,广东省
gtschool.cn	题型,专四,专八,英语,作文
##ciciguo.com	整体,产品,细胞,调理,减肥
##rsdxt.com	７２８
##dxmeat.com	预测
